a: an
abandon: abandoned
abase: abasing
abhor: abhorreth, abhorrence, abhorrest
abide: abides
able: abled
abolish: abolished
abomination: abominable, abominations
abound: abounding, abundant, abundance, abundantly
abridge: abridged, abridgment, abridging
abuse: abused
accept: acceptable
accomplish: accomplished, accomplishment
accord: according, accordingly
account: accountable, accounted, accounts
accurse: accursed
accuse: accusation, accusing, accused
acknowledge: acknowledged, acknowledges, acknowledgeth
acquaint: acquainted
acquire: acquired
acre: acres
act: acted, acting, activity, activities
add: added, addition
administer: administering, administered, administers
admit: admitted, admitting
admonish: admonished, admonishing, admonition, admonitions
adopt: adopted
adorn: adorning
adultery: adulterer, adulterers, adulterous
advantage: advantages
adverse: adversaries, adversary
advocate: advocateth
affair: affairs
affection: affections
affix: affixed
afflict: affliction, afflicted, afflictions
afford: afforded
after: afterward, afterwards
agate: agates
age: aged, ages
aggravate: aggravating
agree: agrees, agreed, agreement, agreements
alarm: alarming
allot: allotted, allotteth
allow: allowance
ally: alliance, alliances
alm: alms
alter: alteration, altering, altered
always: alway
amalekite: amalekites
amalickiahite: amalickiahites
amaze: amazed, amazement, amazing
amlicite: amlicites
ammonihahite: ammonihahites
ammonite: ammonites
among: amongst
amount: amounted
amulonite: amulonites
anchor: anchors
ancient: ancients, anciently
angel: angels, angelic
anger: angry, angried
animal: animals
ankle: ankles
anoint: anointing, anointed
answer: answering, answered
anxiety: anxious
any: anyone, anything, anywhere
apostle: apostles
appeal: appealed
appear: appearing, appears, appeareth, appearance, appeared
appease: appeased
apply: applied
appoint: appointed
apprise: apprised
approach: approaching
arise: ariseth, arises
arm: arming, armed, arms, army, armies
arraign: arraigned
array: arrayed
arrive: arrives, arrived
arrogance: arrogant, arrogancy
arrow: arrows
art: arts
artifice: artificer
ascend: ascendeth, ascended, ascension
ascribe: ascribing
ash: ashes
ask: asked, asking, asketh
ass: asses
assemble: assemblies, assembling, assembly, assembled
assist: assistance
associate: associated, associates
assure: assurance, assurances, assured, assuredly
assyria: assyrian
astonish: astonishing, astonishment, astonished
atone: atoneth, atoning, atones, atonement
attack: attacked
attempt: attempting, attempts, attempted
attend: attended, attention
attitude: attitudes
attribute: attributed
author: authors
authority: authorities, authoritative
avail: availeth
avenge: avengeth, avenging
awful: awfulness
awkward: awkwardness
babble: babbling, babblings
babe: babes
back: backs
bald: baldness, balding
band: bands
banish: banished
bank: banks
baptize: baptizing, baptism, baptized
barge: barges
barn: barns
base: baseness
bat: bats
bath: bathe
battle: battles, battled
bear: beareth, bearing, bearer, bore, borne
beast: beasts
beat: beaten
beauty: beautiful
be: beings, being, been, am, is, are, was, were, wast
beckon: beckoned
become: becomes, becometh, becoming, became
bed: beds, bedding
bee: bees
before: beforehand
begat: begotten
beg: begged, begging, beggar, beggars
begin: beginneth, beginning, began, begun
behold: beholding, beheld, beheldest, beholdest
behoove: behooveth
believe: believers, believing, believeth, believed, belief, believest
bellow: bellows
belong: belonging, belongs, belongeth, belonged
beseech: besought
beside: besides
bestow: bestowed
between: betwixt
bid: bidding, bidden, bade
bind: binds, bindeth, bound
bite: bitten
bitter: bitterness
black: blackness
blade: blades
blaspheme: blasphemy
bless: blessings, blessing, blessed
blind: blinded, blindness, blindeth
block: blocks
blood: bleeding, bleed, bloodsheds, bloodshed, bloodthirsty, bled, bloody
blossom: blossoms
blot: blotted
blow: bloweth, blows, blew
boast: boastings, boasting
body: bodies
bold: boldness, boldly
bond: bonds, bondage
bone: bones
bonnet: bonnets
book: books
border: bordered, bordering, borders
birth: born
borrow: borroweth
bounty: bountiful, bountifully
bow: boweth, bowed, bows
bowel: bowels
bracelet: bracelets
branch: branches
brave: bravery
break: breaking, breaketh, brake, broke, broken
breast: breasts
breastplate: breastplates
breath: breathe, breathing, breathed
brick: bricks
brier: briers
bright: brightness
bring: bringing, bringeth, brought
brother: brothers, brethren
bruise: bruised
brutal: brutality
buckler: bucklers
build: buildeth, buildings, building, built, rebuilt
burden: burdened, burdeneth, burdens, burdensome
burn: burneth, burning, burned, burnt
bury: burying, buried, burial
bush: bushes
buy: bought
calamity: calamities
calf: calves
call: callings, calling, called
camp: camped, camps, encamp
can: canst, could
candle: candles
canker: cankered
captain: captains
captive: captivate, captivation, captives, captivity
carbuncle: carbuncles
carcass: carcasses
care: careful, carefully
carnal: carnally
carriage: carriages
carry: carrieth, carrying, carried
case: cases
cast: casteth, casting
catch: caught
caul: cauls
cause: causes, causeth, causing, caused
cave: caves
cavity: cavities
cease: ceaseth, ceasing, ceased, ceases
cedar: cedars
censure: censured
ceremony: ceremonies
certain: certainly
chain: chained, chains
chaldean: chaldeans
chance: chances
change: changeth, changing, changed, changeable
channel: channels
character: characters
charge: charges
chariot: chariots
charity: charitable
charm: charmed
chase: chased
chaste: chastity
chasten: chastened
chastise: chastisement
cheat: cheateth, cheater, cheating
check: checked
cheek: cheeks
cheer: cheerful, cheerfully
cherub: cherubim, seraphim
chicken: chickens
chief: chiefs, chiefly, chiefest
child: children, childish, childishness, childhood
choice: choose, choosing, chose, chosen, choicest
choir: choirs
christ: christs
christian: christians
church: churches
cimeter: cimeters
circumcise: circumcised, circumcision
circumspect: circumspectly
circumstance: circumstances
city: cities
civil: civilization, civilized
claim: claimeth
clap: clapped
clasp: clasped
class: classes
clean: cleanse, cleansed
clear: cleared, clearly
cleave: cleaveth, clave
cleft: clefts
cling: clinging
close: closed
closet: closets
cloth: clothes, clothed, clothing, clothe
cloud: clouds
club: clubs
coal: coals
coarse: coarseness
cockatrice: cockatrices
collect: collected, collection
color: colors, colored
combine: combined, combination, combinations
come: comes, coming, cometh, came, comest
comely: comeliness
comfort: comforter, comforteth, comforted, comfortedst
command: commanding, commander, commands, commandeth, commandment, commanded, commandments, commandest
commence: commenced, commencement
commend: commending
commit: committeth, committing, committed
communicate: communication
compare: compared
compass: compassion
compel: compelled
complain: complaining, complained, complaint, complaints
compose: composed
comprehend: comprehendeth
conceal: concealed
conceive: conceived, conceives
concern: concerned, concerning
concourse: concourses
concubine: concubines
condemn: condemning, condemneth, condemned, condemnation
condescend: condescensions, condescension
condition: conditions
conduct: conducted
confederate: confederacy
confer: conferred
confess: confesses, confessing, confessed
confine: confined
confirm: confirming
confound: confounding, confoundeth, confounded
confuse: confusion, confused, confuses
congregate: congregation, congregations
conquer: conquered, conqueror, conquerors
conscious: consciousness
consecrate: consecrating, consecrated
consequence: consequences
consider: considered, considering, considerable, considerest
consign: consignation, consigned
consist: consisting, consisted, consists
console: consoling, consolation
constelation: constellations
constrain: constraineth, constrained
construct: construction
consult: consulted
consume: consumeth, consuming, consumed, consumption
contain: containeth, contains, contained
contend: contendeth, contending, contended
content: contents
continue: continuing, continued, continual, continually
contrary: contention, contentions, contentious
converse: conversing, conversed
convert: converted, conversion
convey: conveyed
convince: convincing, convinced
cord: cords
corner: corners
correct: correction, correctness
correspond: correspondence, corresponded
corrupt: corruptness, corruption, corrupted
cost: costly, costliness
counsel: counseled, counseleth, counsels
count: counted
countenance: countenances
country: countries
course: coursed, courses
covenant: covenanteth, covenanting, covenanted, covenants
cover: covering, covered
cow: cows
crack: cracks
crafty: craftiness
create: creating, created, creation, creator
creature: creatures
credit: creditor, creditors
crime: crimes
crisp: crisping
critic: critical, critique
crook: crooked
crop: crops
cross: crosses, crossing, crossed
crucify: crucified, crucifiction
cruel: cruelty
crumble: crumbled
crush: crushed
cry: crieth, cries, cried, crying
cumber: cumbered
cumom: cumoms
cure: cures, curing
curelom: cureloms
curse: curseth, cursing, cursed, curses
curtain: curtains
cut: cuts, cutteth, cutting
dagger: daggers
damn: damnation, damned
dance: danced
danger: dangerous
dare: daring, durst
dark: darkness, darken, darkened, darkest
dart: darts
dash: dashed
daughter: daughters
daunt: daunted
day: days, daily
dead: deadly, deadness, death, deaths
deaf: deafness
deal: dealing, dealings
dear: dearly
debt: debts, debtor, debtors
decay: decayed, decadence
deceit: deceits, deceitful, deceitfully, deception
deceive: deceiving, deceivings, deceived, deceiver
declare: declareth, declaring, declared
decline: declined
decree: decreed, decrees, decreeth
deed: deeds
defend: defended, defending, defence
defile: defiled
deform: deformed
defy: defiance, defied, defies
degree: degrees
delay: delays, delayed
delibert: deliberately, deliberate
delight: delighting, delighted, delighteth, delightsome
deliver: deliverance, delivereth, delivering, delivered, delivers
demand: demanded, demanding, demands
demon: demons
den: dens
deny: denieth, denying, denied, deniest
depart: departeth, departed, departure
depend: depended, dependent
deposit: deposited
deprave: depravity
depress: depressed
deprive: deprived, depriving
depth: depths
derange: derangement
descend: descends, descended, descending, descendants, descendant
describe: description
desert: deserting, deserts, deserted
design: designs
desire: desirable, desireth, desiring, desires, desired, desirous, desirest
desolate: desolation
desperate: desperately
despise: despisers, despising, despiseth, despised
despite: despiteful, despitefully
destroy: destroyeth, destroying, destroyed, destroyer, destroyers
destruct: destructions, destruction
determine: determination, determined
dethrone: dethroned, dethroning
device: devices
devil: devils
devise: devised
devour: devourer, devoureth, devouring, devoured
did: didst
die: dies, dieth, died, dying
differ: different
difficult: difficulty
dig: digging, digged
diligent: diligently, diligence
dim: dimness, dimmed
direct: direction, directed, directions, director
disadvantage: disadvantages
disappoint: disappointment, disappointed
disbelieve: disbelieves
discern: discernible
disciple: disciples
discover: discovers, discovered
disease: diseases
disfigure: disfigured
disguise: disguised
dismiss: dismissed
disobedy: disobedience
disown: disowned
dispel: dispelled
disperse: dispersion, dispersed
displease: displeased
dispute: disputing, disputings, disputations
dissent: dissenter, dissenting, dissented, dissenters, dissension, dissensions
dissolve: dissolved
distant: distance
distinguish: distinguished
distress: distressing
disturb: disturbed, disturbance, disturbances
ditch: ditches
diverse: divers
divide: divides, dividing, divideth, divided, divisions, division
divise: divised
divorce: divorced, divorcement
divulge: divulged
doctrine: doctrines
do: doer, doers, doing, doings, doeth, does, doest, done, doth, did
dog: dogs
dole: doleful
dominion: dominions
door: doors
double: doubled
doubt: doubted, doubtful, doubtings, doubting
drag: dragged
dragon: dragons
draw: draweth, drawn, drew
dread: dreadful
dream: dreamed, dreameth, dreams
dreg: dregs
dress: dressed
dri: dried
drink: drinking, drinketh, drunken, drunkenness, drunk
drive: driving, driven, drove
drown: drowned
dung: dunged
dungeon: dungeons
duration: durable
dwell: dwellings, dwells, dwelling, dwelleth, dwellest, dwelt
dwindle: dwindled, dwindles, dwindling
dye: dyed
ear: ears
early: earlier, earliest
earnest: earnestness
earthquake: earthquakes
ease: eased, easiness, easy, easily, easier
east: eastward
eat: eateth, ate, eaten
edge: edges
effect: effectual, effective
egg: eggs
egyptian: egyptians
eighteen: eighteenth
eight: eighth
eighty: eightieth
elder: elders, eldest
elect: elected
element: elements
elephant: elephants
eleven: eleventh
embarrass: embarrassed, embarrassments
embassy: embassies
embrace: embraced
employ: employed, employeth
empty: emptied
enable: enabled
enact: enacteth
encircle: encircles, encircled
enclose: enclosed
encompass: encompassed
endeavor: endeavored, endeavoring
end: endeth, ending, ends, ended, endless, endlessly
endure: endured, endurance, endureth
enemy: enemies
energy: energies
engrave: engraved, engraving, engravings, engraven
enjoy: enjoyed, enjoyment
enormity: enormous
enter: entereth, entering, entered
entice: enticed, enticing, enticings, enticeth
entire: entirely
entrance: entrances
entreat: entreated
enumerate: enumerated
envy: envieth, envying, envyings
epistle: epistles
equal: equality, equals, equity, equitable
erect: erecting, erected
err: erred, error, errors, erred
escape: escaped, escapes
establish: establishment, establishing, established
esteem: esteemeth, esteeming, esteemed
eternity: eternally, eternal
eve: evening
everlast: everlasting, everlastingly
every: everyone, everything, everywhere
evidence: evidences
evil: evils
exact: exacted, exactness
exalt: exalted
examine: examined
example: examples
excel: excellency, excellent
excess: exceed, exceeded, exceeding, exceedingly
exchange: exchanged
exclaim: exclaimed, exclaimeth
excuse: excused
execute: executeth, executed, executes
exercise: exercises, exerciseth, exercising, exercised
exert: exerted
exhaust: exhausting, exhausted
exhort: exhortation, exhorted, exhorting
exile: exiled
exist: existence
expedient: expedience
experience: experienced, experiment
expert: expertness, expertly
explain: explaining, explained
expose: exposed
expound: expounded
express: expressed, expressly
exquisite: exquisitely
extend: extending, extended
extinct: extinction, extinguish
extol: extolled
extreme: extremely
eye: eyes
face: faces
faculty: faculties
fade: fadeth, faded, fades
faggot: faggots
fail: faileth
faint: fainteth, fainted
faith: faithfulness, faithful
fall: falleth, falling, fallen
false: falsely
family: families
famine: famines, famish, famished
fare: fared
far: farther, further, furthermost, afar
fast: fasted, fasting, fasten, fastened, faster, fastest
fat: fatness, fatling, fatlings
father: fathers
fatigue: fatigued
fault: faults
favor: favors, favored
fear: feareth, fears, fearful, fearing, feared, afraid
feast: feasts, feasting
feed: feedeth, feeding, fed
feel: feelings, feeling, felt
fell: felled
fellow: fellowship
female: females
fence: fenced
fever: fevers
field: fields
fierce: fierceness, fiercely, ferocious, ferocity
fifteen: fifteenth
fifty: fiftieth
fig: figs
fight: fighteth, fighting, fought
fill: filleth, fills, filling, filled
filth: filthy, filthiness
final: finally
find: findeth
finger: fingers
finish: finisher, finished
firebrand: firebrands
fire: fires, fiery
firm: firmness, firmly, firmer
firstling: firstlings
fist: fists
five: fifth
fix: fixed
flame: flames, flaming
flatter: flattereth, flattered, flattering, flattery, flatteries
flee: fleeing, fleeth, fled
flock: flocking, flocks
flood: floods
fly: flying, flew, flight
follow: followed, followers, following
fool: fools, folly, follies, foolish, foolishness
foot: feet
forbad: forbade
forbid: forbidden
force: forces, enforce, enforced
forefather: forefathers
forehead: foreheads
foresee: foreseen
forest: forests
forget: forgetting, forgettest, forgot, forgotten
forgive: forgiveth, forgiveness, forgiven
format: formatted
form: forms, formed, formation
fornicate: fornication
forsake: forsaking, forsaken
fort: forts, fortifications, fortify, fortifying, fortified
forty: fortieth
foundation: foundations
found: founded
fountain: fountains
four: fourth
fourteen: fourteenth
fowl: fowls
fragment: fragments
frail: frailties, frailty
frame: framed, frames
frank: frankly
free: freely, freed, freedom, freeman, freemen
frenzy: frenzied
friend: friends, friendly
fright: affright, affrighted, frighten, frightened
fruit: fruitful, fruits
frustrate: frustrated, frustration
fulfil: fulfilleth, fulfill, fulfilling, fulfilled
full: fulness, fully
furnace: furnaces
fury: furious
gain: gained
gainsay: gainsaying
garment: garments
garner: garners
gate: gates
gather: gathering, gathereth, gathered
general: generals
generation: generations
generous: generosity, generously
genius: geniuses
gentile: gentiles
gentle: gentleman, gentlemen, gently
get: getteth
gift: gifts
gird: girding, girded, girdle
give: gives, giving, giveth, gave, given
glad: gladness, gladly
glance: glanced
glass: glasses
glory: glorified, glorify, glorious
glut: glutting
gnash: gnashing
goat: goats
god: gods, godly, godliness
go: goeth, going, goes, goest, gone, went
gold: golden
good: goods, goodness, goodly
got: gotten
govern: governments, governed, government, governor, governors
graft: grafting, grafts, grafted
grant: granteth, granted
grape: grapes
grasp: grasped, grasps
gratify: gratified
grave: graves
great: greatness, greatly, greater, greatest
grief: griefs, grieve, grieves, grieved, grieveth, grievous, grievously, grievousness
groan: groaned, groaneth, groanings
gross: grossly, grosser, grossest
ground: grounds
grove: groves
grow: groweth, grew, grown
grudge: grudging, grudgingly
guard: guarded, guards
guess: guessed
guide: guides, guided
guile: beguile, beguiled
guilt: guilty
gush: gushed, gushing
habitat: habitation, habitations
hail: hailed
hair: hairs
half: halve, halves
hallow: hallowed
halt: halted
hand: handing, handed, hands
handle: handled
handmaid: handmaids
hang: hanged, hangeth, hung
happen: happened
happy: happiness, happier
hard: hardness, harden, hardening, hardeneth, hardened, harder
harlot: harlots
harrow: harrowed
harsh: harshly, harshness
has: hast, hath
haste: hasten, hasteneth
hate: hated, hatred
haughty: haughtiness
have: having, had, hadst
headband: headbands
head: headed, heads
heal: healeth, healings, healing, healed, healer
heap: heapeth, heaping, heaps, heaped
hear: hearer, hearers, heareth, hearing, heard, heardest, hearest
hearken: hearkening, hearkeneth, hearkened
heart: hearted, hearts
heat: hot
heaven: heavenly
heaven: heavens
hedge: hedged
heed: heeded
he: his, him, himself
height: heights
heir: heirs
help: helped
hem: hemmed
herd: herds
here: hither
heritage: heritages
hew: heweth, hewn
hide: hiding, hideth, hid, hidden
high: highness, highly, higher
highway: highways
hill: hills
hilt: hilts
hinder: hindereth, hinderment
hint: hinted
hire: hired, hireling
history: histories
hoist: hoisted
hold: holds, holding, held
hole: holes
holy: holiness
home: homely, homes
honor: honorable, honorary
hood: hoods
hoof: hoofs, hooves
hook: hooks
hope: hopeth, hoped, hoping, hopes
horrible: horrid, horribly
horse: horses
host: hosts
hour: hours
house: houses
how: howbeit
howl: howling, howlings
humble: humbly, humbleth, humbled, humility
hundred: hundreds, hundredth
hunger: hungered, hungry
hunt: hunted, hunter
husband: husbands
hush: hushed
hypocrisy: hypocrite, hypocritical, hypocrites
idle: idleness
idol: idols, idolatrous, idolatries, idolatry
ignominy: ignominious
ignorance: ignorant, ignorantly
illuminate: illuminated, illumination
image: images
imagine: imagining, imaginations, imagined
i: me, my, mine, myself, self
immediate: immediately
immense: immensely
immerse: immersed
immortal: immortality
impart: imparteth, imparting, imparted
impede: impeded
imperfect: imperfections, imperfection
important: importance
import: imports, imported
improve: improved
incorrect: incorrectness, incorrectly
incorrupt: incorruptible, incorruption
increase: increased, increases
incur: incurred
indebt: indebted
indignant: indignation
indolent: indolence, indolently
indulge: indulgent, indulgence
industry: industrious
inequal: inequality
infant: infancy
infest: infested
infirm: infirmities
inflame: inflamed
inflict: inflicteth, inflicting, inflicted
inform: information, informing, informed
infuse: infused
inhabit: inhabitant, inhabited, inhabitants
inherit: inherited, inheritance
iniquity: iniquitous, iniquities
injure: injures, injured, injury, injuries
injustic: injustice
innocent: innocence
inquire: inquired
insect: insects
inspire: inspired, inspiring
instance: instances
instruct: instructions, instruction, instructed
instrument: instruments
insurrect: insurrections
intent: intentions, intents, intention
interpret: interpreting, interpreted, interpreters, interpretation
intrigue: intrigues
introduce: introduced
invite: invited, invitation, inviteth
inward: inwardly
ishmaelite: ishmaelites, ishmaelitish
island: islands
isle: isles
israelite: israelites
it: its, itself
jacobite: jacobites
jaredite: jaredites
jealous: jealousy
jewel: jewels
jew: jews
join: joins, joining, joined
joint: joints
josephite: josephites
journey: journeys, journeying, journeyings, journeyed
joy: joyed, joyous, joyful
judge: judgeth, judged, judges
judgment: judgments
just: justly, justify, justified, justifieth, justice
keep: keepeth, keeping, keeper, kept
key: keys
kill: killeth, killed
kind: kindness, kinds
kindle: kindled
kindred: kindreds
kingdom: kingdoms
king: kings
kiss: kissed, kissing
knee: knees
kneel: kneeled, knelt
knock: knocketh
know: knows, knowing, knoweth, knowingly, knowledge, knew, knewest, known, knowest, wist, wot
labor: laborer, laborers, laboring, labored, labors
lack: lacking
ladder: ladders
lamanite: lamanites
lamb: lambs
lament: lamented, lamenting, lamentations, lamentation
land: landing, lands
language: languages
large: larger, enlarged, enlarge
lascivious: lasciviousness
lash: lashed
last: lasted, lasting
late: later
laugh: laughed, laugheth
launch: launched
law: lawful, laws
lawyer: lawyers
lay: layeth, laying, laid, liest
lazy: laziness
leader: leaders
lead: leads, leading, leadeth, led
lean: leaned, leanness
leap: leaped
learn: learning, learned, learner
leather: leathern
leave: leaves, leaving
leg: legs
lemuelite: lemuelites
lend: lending
length: lengthen, lengthened
leprosy: leprous
less: lesser
let: letting
level: leveled
liar: liars
liberal: liberally
liberty: liberties, liberate, liberated
lie: lieth, lies, lied, lyings, lying
life: live, lively, lived, liveth, living, lives, alive, livest
lift: lifting, lifted
light: lighted, lightness, lights, lightly, enlighten, enlightened
lightning: lightnings
like: likeness, liken, likened, likewise, alike
lily: lilies
limb: limbs
lion: lions
lip: lips
liquor: liquors
listen: listened
list: listed, listeth
load: loading, laden
loath: loathsome
lodge: lodging
lofty: loftiness
loin: loins
lone: alone, lonely
long: longer
look: looketh, looks, looking, looked
loose: loosing, loosed
lose: lost, loss
lot: lots
love: loving, loveth, loved, beloved, lovest
low: lowliness, lowly, lower
lust: lusts
machine: machinery
made: madest
magic: magics
magnify: magnified
maid: maids, maiden
maim: maimed
maintain: maintained, maintaining, maintenance
majesty: majestic
make: maketh, making
manage: managed, management
mangle: mangled
manifest: manifestation, manifesteth, manifesting, manifestations, manifested
man: men
mansion: mansions
mantle: mantles
march: marching, marched
mark: marked, marks
mar: marred
marry: marriage, married
marvel: marveling, marvelings, marveled, marvelous
massacre: massacres, massacred
master: masters
matter: matters, mattereth
may: mayest
mean: meaning, meaneth, means, meant
measure: measured
mediate: mediator
meek: meekness
meet: meetings, meeting, met
melody: melodies
melt: melted, melting
memory: memories
mend: mended, mending
merchant: merchants
mercy: mercies, merciful, mercifully
mere: merely
merit: merits
message: messages
messenger: messengers
metal: metals
mid: middle
might: mights, mightily, mighty, almighty, mightest, mightier
mild: mildness
million: millions
mince: mincing
mind: minded, mindful, minds
mingle: mingled, mingleth, mingles
ministry: ministers, ministering, ministered, minister
miracle: miracles, miraculously, miraculous
mischief: mischiefs
misery: miserable
miss: missing
mistake: mistakes
mist: mists
mix: mixed, mixeth, mixture
mock: mocked, mockery, mocking
moist: moisture
molder: moldering
mole: moles
monarch: monarchy
money: monies
month: months
moon: moons
morn: morning
mortal: mortality
mother: mothers
motion: motions
mountain: mountains
mourn: mounful, mournfully, mournings, mourned, mourning
mouth: mouths
move: movement, movements, moveth, moved
muffle: muffler, mufflers
multiply: multiplied, multiplication
multitude: multitudes
murder: murdereth, murderings, murderous, murderer, murdering, murderers, murdered, murders
murmur: murmuring, murmurings, murmured
muster: mustereth
mystery: mysterious, mysteries
nail: nails
naked: nakedness
name: named, names
narrow: narrowly, narrowness
nation: nations
nature: natures, natural
nea: neas
near: nearly, nearer
necessary: necessarily
neck: necks
need: necessary, necessarily, needed, needs, needy
neglect: neglected
nehor: nehors
neighbor: neighboring
nephite: nephites
new: newly, news, anew
night: nights, nighttime
nine: ninth
nineteen: nineteenth
ninety: ninetieth
noble: nobles, nobility
noise: noised, noises
no: nay, none, nothing, nowhere, nowise
north: northern, northward, northernmost
nostril: nostrils
note: notable, noted, notice, noticed
nothing: nothingness
nourish: nourishing, nourishment, nourished
number: numbereth, numbers, numbered
nurse: nursed, nursing
nurture: nurtured
oak: oaks
oath: oaths
obey: obedience, obedient, obeyed, obeyeth, obeying
oblige: obliged
obscure: obscurity
observe: observance, observing, observed, observes
obstruct: obstruction
obtain: obtaining, obtained
occasion: occasioned
occupy: occupied
offend: offender, offended, offense
offer: offered, offereth, offerings, offering
office: officers, offices
often: oft
old: older, oldest
olive: olives
one: ones, first, once
onti: onties
open: opening, opened, openly
operate: operated, operation
opportunity: opportunities
oppose: opposed, opposes
opposite: opposition
oppress: oppressions, oppression, oppressed, oppressor, oppressors
orate: orator
ordain: ordained
order: ordered, orders
ordinance: ordinances
ore: ores
ornament: ornamented, ornaments
orphan: orphans
other: others, another
ourself: ourselves
outcast: outcasts
out: outer, outward
overbear: overbearance
overcome: overcoming
overlook: overlooked
over: overflow, overrun, overspread
overpower: overpowereth, overpowering, overpowered
overshadow: overshadowing, overshadowed
overtake: overtaken
overthrow: overthrew
owe: owed, owes
owl: owls
ox: oxen
pain: pained, pains
palace: palaces
pale: paleness, paled
palm: palms
pang: pangs
parent: parents
partake: partaking, partakers, partaken
particle: particles
particular: particularly
partner: partners
part: parted, parts
party: parties
passage: passages
passion: passions
pass: passing, passeth, passed
pastor: pastors
pasture: pastures
path: paths
pay: paying, paid
peacemaker: peacemakers
peace: peaceably, peaceable, pacify, pacified
peak: peaked
pearl: pearls
peep: peeped
penal: penalty, penalties
penetrate: penetrated
perceive: perceiving, perceived, perception
perfect: perfected, perfection, perfectness, perfectly
perform: performance, performed, performances
perish: perishing, perisheth, perished
permit: permitted
persecute: persecuting, persecuted, persecution, persecutions
persist: persisted, persists
person: persons, peopled, people
persuade: persuading, persuaded, persuadeth, persuasions
pertain: pertaining
pervert: perverteth, perverted, perverting, perverse, perversion
pestilence: pestilences
petition: petitions
philistine: philistines
picket: pickets
picture: pictures
piece: pieces
pierce: piercing, pierced, pierces
pin: pins
pitch: pitched
pit: pits
place: placing, placed, places
plain: plains, plainness, plainly
planet: planets
plan: plans
plant: plants, planted
plate: plates
play: played
plead: pleaded, pleadeth, pleading, pled
please: pleasing, pleasingly, pleased
pleasure: pleasures, pleasured
plenty: plentiful, plentifully
plot: plots
pluck: plucked
plunder: plundered, plunderers, plunderings, plundering
plunge: plunged
point: pointed, pointing, points, pointer, pointers
poison: poisonous
polish: polished
pollute: pollutions, polluted
ponder: pondereth, pondering
pool: pools
poor: poorer, poorest
possess: possessing, possessions, possessed, possession
possible: possibly, possibility
post: posts, poster, posters
pour: pouring, poured
poverty: impoverish, impoverished
power: powers, powerful, powerfully
practice: practices, practiced
praise: praised, praising, praises
pray: prayeth, praying, prayed, prayer, prayers, prayest
preach: preachings, preached, preaching, preacher, preachers
precept: precepts
prepare: preparator, preparation, prepareth, preparing, preparations, prepares, prepared, preparatory
prescribe: prescribed
present: presented
preserve: preservation, preserving, preserved, preserves
preside: presided
press: presses, pressed, pressing
pretend: pretendeth, pretended
prevail: prevailed
pride: proud, proudly
priestcraft: priestcrafts
priest: priests
prince: princes
principle: principles
print: prints
prison: prisoner, prisons, prisoners
private: privation, privately, privily
privilege: privileged, privileges
probation: probationary
proceed: proceeding, proceeded, proceedings, proceedeth
proclaim: proclaimed, proclamation
procrastinate: procrastinated, procrastination
profane: profaned
profess: profession, professed
profit: profiteth
prolong: prolonged
promise: promising, promises, promised
pronounce: pronounced
prophecy: prophecies, prophesyings, prophesieth, prophesying, prophesied, prophesy
prophet: prophets, prophetess
propose: proposed
prosper: prospereth, prospering, prosperous, prospered, prosperity
prostrate: prostrated, prostrates
protect: protected, protection, protector
prove: proveth, proved, proving, proven
providence: providing, provide, provided
provision: provisions
provoke: provoketh, provoked, provocation
prudent: prudently
prune: pruning, pruned
publish: published, publishing, publisheth
puff: puffing, puffed
pull: pulling
punish: punishments, punished, punishment
pure: purifier, purify, purifying, purified, purity
purge: purged
purpose: purposed, purposes
pursue: pursuing, pursued
put: putting, putteth
quake: quakings, quaking
quality: qualities
quarrel: quarrelings
quarter: quarters
queen: queens
question: questioned, questions
quick: quickly
quiet: quieted, quietly
rack: racked
rage: raging
rag: ragged
rail: railing
rain: rains
raise: raiseth, raising, raised
rank: ranks
ransom: ransomed
rash: rashly
ration: rations
ravenous: ravening
ravish: ravished
reach: reached
read: readeth, reading, reader
ready: readiness
real: reality, really, realize
rear: rearward
reason: reasonable, reasons
rebel: rebelleth, rebelling, rebelled, rebellion, rebellions, rebellious
rebuke: rebuked
recall: recalled
recede: receded
receive: receiving, receiveth, received, reception, receivedst
reckon: reckoning
reclaim: reclaimed
recollect: recollection
reconcile: reconciles, reconciled
record: records
recover: recovered, recovers
redeem: redeeming, redeemeth, redeemed, redeemer, redemption
redouble: redoubled
reduce: reduced
refine: refiners, refined, refiner
reform: reformed
refuse: refuseth, refused
regain: regaining, regained
region: regions
regular: regulate, regulation, regulations
rehearse: rehearsed
reign: reigns, reigneth, reigned
rein: reins
reject: rejecteth, rejecting, rejected
rejoice: rejoiceth, rejoicings, rejoiced, rejoicing, rejoices
relate: related, relates
release: released
relieve: relieved
relinquish: relinquished
reluctant: reluctantly, reluctance
rely: relying, relies
remain: remains, remaining, remaineth, remained, remainder
remark: remarkable
remember: remembering, remembereth, remembered, remembrance, rememberest
remind: reminding, reminded
remiss: remission
remnant: remnants
remorse: remorseful
remove: removing, removes, removed
render: rendered
rend: rending
renew: renewed
renown: renowned
repair: repaired
repay: repaid
repeat: repetition, repetitions
repent: repents, repenting, repenteth, repented, repentance
replenish: replenished
reply: replied
represent: representation, represents, represented
reprove: reproveth, reproved
repulse: repulsed
repute: reputation
request: requested
require: requires, requireth, required, requisite
rescue: rescued
reserve: reserved
resist: resistance, resisting
resolute: resolution
resolve: resolving, resolves, resolved
resort: resorted
respect: respecter, respectful
responsibility: responsibilities
restore: restoring, restoration, restored
restrain: restrained
rest: rested
resurrect: resurrection
retain: retaining, retained
retake: retaking, retaken
retire: retired
retreat: retreats, retreated
return: returning, returned, returneth
reunite: reunites, reuniting, reunited
reveal: revealed
revel: revelator, revelations, revelation
revenge: revenged
revere: reverence, reverent
revile: revilings, reviled
revive: revived, revives
revolt: revolted, revolution
reward: rewardeth, rewards, rewarded
rich: riches
ridge: ridges
right: righteous, righteously, righteousness, rightly, rights
rim: rims
ringlet: ringlets
ring: rings
riot: riotings, riotous
ripe: ripeness, ripen, ripened, ripening
rise: rising, arose, arouse, risen, risest
risk: risked
rite: rites
river: rivers
road: roads
roar: roared, roaring
rob: robbings, robbing, robbed, robber, robbers, robbery
rock: rocks
roll: rolled
root: rooted, roots
rot: rotten, rottenness
rude: rudeness
ruin: ruined, ruins
rule: ruled, ruleth, ruling, ruler, rulers
rumor: rumors
run: running, ran
rush: rushed
sacred: sacredness
sacrifice: sacrifices, sacrificed
sad: sadden, saddened
safe: safely, safety
sail: sailed
saint: saints
sake: sakes
sally: sallying
salt: salted
same: selfsame
sanctify: sanctified, sanctification
sanctuary: sanctuaries
sand: sands, sandy
sapphire: sapphires
satisfy: satisfieth, satisfaction, satisfied
satyr: satyrs
save: saveth, saving, saved, salvation, savior, saviour
say: says, sayings, saying, said, saidst, saith, sayest
scale: scales
scanty: scantiness
scarce: scarcely
scarlet: scarlets
scatter: scattereth, scattering, scattered
scepter: scepters
scoff: scoffing, scoffed
scorch: scorched, scorcheth
scorn: scornful, scorner
scourge: scourged, scourges
scripture: scriptures
seal: sealing, sealed
seam: seams
search: searches, searching, searched
seashore: seashores
season: seasons
seat: seats
secrete: secreted
secret: secrecy, secretly, secrets
secure: secured, secures, security
seduce: seduced
seed: seeds
seek: seeketh, seeking, seeker, sought
seem: seemeth, seems
see: sees, seeing, seeth, seer, seers, saw, sawest, seen, seest, sight
seize: seized, seizes
select: selected
sell: sold
send: sending, sendeth, sends, sent
senine: senines
sense: senses
senum: senums
separate: separately, separation, separated
sepulchre: sepulchres
serpent: serpents
servant: servants
serve: served, serveth, service, serviceable, serviced
set: setteth, setting
settle: settles, settled
seven: seventh
seventeen: seventeenth
seventy: seventieth
severe: severally, severity, several
shadow: shadows
shaft: shafts
shake: shaketh, shaken
shall: shalt, should, shouldst
shame: ashamed
share: shares, shared
sharp: sharpness, sharply
shave: shaved, shaven
shearer: shearers
sheave: sheaves
shed: shedding, sheddeth
she: her, hers, herself
shepherd: shepherds
shiblon: shiblons
shield: shielded, shields
shine: shined, shining, shone
ship: shipping, ships
shoe: shoes, shod
shoot: shot
shore: shores
short: shorten, shortened, shortly, shorter
shoulder: shoulders
show: showeth, showing, showed, shown
shrink: shrunk
sickle: sickles
sick: sickness, sicknesses, sicken
side: sides
sign: signed, signs, signify
silence: silenced, silences
silk: silks
silverling: silverlings
similar: similitude
simple: simpleness
sincere: sincerity
sing: singing, song
sink: sunk
sinner: sinners
sin: sinful, sinned, sins
sister: sisters
sit: sitteth, sitting, sat
situation: situations
six: sixth
sixteen: sixteenth
sixty: sixtieth
skill: skilful, skills
skin: skins
skirt: skirts
slack: slacken, slackened
slaughter: slaughtered, slaughters
slave: slaves, slavery
slay: slayeth, slaying, slain, slew
sleep: sleepeth, asleep, slept
sling: slings
slip: slipped, slippery
sloth: slothfulness, slothful
slow: slowest, slower
slumber: slumbered
small: smallest
small: smallness
smile: smiled
smite: smiteth, smiting, smiter, smote
smoke: smoking
snare: snared, snares, ensnare, ensnared
snatch: snatched
sober: soberness
sob: sobbings
society: societies
soft: soften, softened, softening, softly
soldier: soldiers
solemn: solemnity
sole: soles
some: someone, something, somewhere, somewhat
son: sons
soon: sooner
soothsay: soothsayers
sorcery: sorceries, sorcerer, sorcerers
sore: soreness, sorely
sorrow: sorrowed, sorroweth, sorrowing, sorrows, sorrowful, sorry
sort: sorts
soul: souls
source: sources
south: southward
space: spacious, spaces, spaced
span: spanned
spare: spareth, sparing, spared
spark: sparks
speak: speaks, speaketh, speaking, spake, speakest, speech, spoken
spear: spears
special: especially
speed: speedily, speedy
spend: spent
spill: split
spindle: spindles
spirit: spirits
spiritual: spiritually
spit: spitting
spoil: spoils, spoiled
spot: spotted
spread: spreading
spring: springing, springs, sprung
sprinkle: sprinkled, sprinkles
sprout: sprouted, sprouteth
spurn: spurneth
spy: spies
stab: stabbed
stain: stains, stained
stake: stakes
stand: standeth, standing, stood
star: stars
start: started
state: stated, stating
station: stations, stationed
statute: statutes
stay: stayed
steadfast: steadfastness, steadfastly
steady: steadiness
steal: stealings, stealing, stole, stolen
step: steps
stiffneck: stiffnecked, stiffneckedness
stiff: stiffen, stiffened, stiffness
stimulate: stimulated
sting: stung
stink: stinketh
stir: stirreth, stirring, stirred
stomach: stomacher
stone: stoning, stoned, stones
stop: stopped, stoppeth
storehouse: storehouses
stout: stoutness
straight: straightness, straightway, straiten, straitened
strange: stranger, strangers
stray: astray
stream: streams
street: streets
strength: strengthen, strengthening, strengthened
stretch: stretches, stretching, stretched
strew: strewed, strewn
strict: strictness, strictly
strife: strifes
strike: striketh, struck
stripe: stripes
strip: stripped
strive: striving
stroke: strokes
stronghold: strongholds
strong: strongly, stronger, strongest
struggle: struggled, struggles, struggling, strugglings
stubborn: stubbornness
study: studied, studies
stumble: stumbled, stumbles, stumbling
subject: subjecting, subjection, subjects, subjected
submit: submitting, submissive
subsist: subsistence
substance: substances
subtle: subtlety
success: succeed, succeeded
succor: succored, succoring
suckle: suckling
suck: sucking
sudden: suddenly
suffer: suffers, suffereth, sufferings, suffering, suffered
suffice: sufficiently, sufficient, sufficeth
suit: suits
supplicate: supplicating, supplicates, supplication
supply: supplies, supplied
support: supporting, supported
suppose: supposeth, supposing, supposed, supposes
sure: surely, surety
surrender: surrendered
surround: surrounded
survive: survives, survived
swallow: swallowed
swarm: swarms
sway: swayed
swear: swearing, swearer, swearers, sware, swore, sworn
sweep: sweepeth
swell: swelled, swelleth, swelling, swollen
swift: swiftness, swiftly, swifter
sword: swords
sycamore: sycamores
synagogue: synagogues
syrian: syrians
tabernacle: tabernacles
tablet: tablets
tail: tails
take: taketh, taking, taken, took
talk: talking, talked
tarry: tarrying, tarried, tarries
task: tasks
taste: tasted, tastes
tax: taxed, taxes, taxation
teach: teacheth, teaching, teacher, teachers, taught
tear: teareth, tears
tease: teasings
tell: tells, telleth, telling
tempest: tempests
temple: temples
temporal: temporally
tempt: tempted, tempting, temptation, temptations
tendency: tendencies
tender: tenderness
tend: tended, tending
ten: tens, tenth
tent: tents
term: terms, termed
terrible: terribly
testify: testifieth, testifying, testified
thank: thanking, thankful, thanks
there: thither, thereat, thereby, therein, thereof, thereon, therewith
they: them, themselves, their, theirs
thicket: thickets
thief: thieve, thieving, thieves
thing: things
think: thinks, thinking, thinketh, thought, thoughts, methought
thirst: thirsted, thirsteth, thirsty, athirst
thirteen: thirteenth
thirty: thirtieth
thistle: thistles
thorn: thorns
thousand: thousands
threat: threaten, threatening, threatened, threatenings
three: third, thrice
throne: thrones
through: throughout
throw: throwing, threw, thrown
thunder: thunderings
tide: tidings, tides
till: tilling
timber: timbers
time: times, sometime, sometimes
tinkle: tinkling
tire: tires
tithe: tithes
title: titles
toil: toiling, toiled
tolerate: tolerable
tomorrow: morrow
tong: tongs
tongue: tongues
tool: tools
tooth: teeth
top: tops
torch: torches
torment: tormented, torments
torture: torturing, tortureth
toss: tossed
touch: touching, touched
toward: towards
tower: towers
town: towns
track: tracks
tradition: traditions, traditional
traitor: traitors
trample: trampleth, trampled
transfigure: transfigured, transfiguration
transform: transformeth
transgress: transgressing, transgresseth, transgressed, transgressions, transgression, transgressor, transgressors
translate: translating, translation, translator, translated
transpire: transpired
trap: traps
travail: travails
travel: traveler, travels, traveling, traveled
treacherous: treacherously
tread: treading, treadeth, trod, trodden
treasure: treasures, treasury
treat: treated
tree: trees
tremble: trembleth, trembled, trembling
tremendous: tremendously
trespass: trespasses
trial: trials
tribe: tribes, tribal
tribulation: tribulations
tribute: tributary
trifle: trifled
triump: triumphant
trouble: troubles, troubled
true: truly
trumpet: trump
trust: trusting, trusted, entrust, entrusted
try: trieth, tried
tumble: tumbled, tumbling
tumult: tumults, tumultuous
turn: turneth, turning, turned
twelve: twelfth
twenty: twentieth
twine: twined
twinkle: twinkling
two: twice, second, secondly, twain
type: types, typify, typifying
unalter: unalterable, unaltered
unavoidable: unavoidably
unaware: unawares
unbelief: unbeliever, unbelieving, unbelievers
unchanging: unchangeable
unclean: uncleanness
understand: understandings, understanding
undertake: undertakings
unequal: unequaled
unfold: unfolding, unfolded
ungodly: ungodliness
unite: uniting, united, unity
unloose: unloosed
unnatural: unnaturally
unrighteous: unrighteousness
unspeakable: unspeakably
unsteady: unsteadiness
unstop: unstopped, unstoppable
unsuccessful: unsuccessfully
unwearied: unwearying, unwearyingness
unworthy: unworthiness, unworthily
uphold: upheld
upright: uprightness, uprightly
upward: upwards
use: useful, used
usurp: usurped
utter: uttered, utterance, utterly
vain: vainness
valiant: valiantly
valley: valleys
value: valued, values
vanish: vanished
vanity: vanities
vapor: vapors
variable: variableness
vary: varying
veil: veils
venture: ventured
verify: verified, verily
vessel: vessels
vex: vexation
victim: victims
victory: victorious, victor
view: viewed, viewing, views
vile: vilest
village: villages
vine: vines
vineyard: vineyards
viol: viols
virgin: virgins
virtue: virtues
vision: visions, visionary
visit: visitations, visitation, visiting, visited
voice: voices
vouch: vouching
vulture: vultures
wade: wading
wage: waged, wages
wail: wailing
wait: waiting, await, awaiteth, awaits
wake: waketh, awake, awaketh, awakes, awaken, awakened, awoke
walk: walketh, walked, walking
wallow: wallowing
wall: walls
wander: wanderer, wanderers, wandering, wandered
want: wants
warm: warmly
warn: warnings, warning, warns, warned
war: warred, wars, warrior, warriors, warfare
wash: washed
waste: wasteth, wasted, wastes, waster
watch: watching, watched, watchful
water: watered, watering, waters, watery
wave: waving, waves
wax: waxed
way: ways
weak: weakness, weaken, weaker, weakest
wealth: wealthy
wean: weaned
weapon: weapons
wear: wearing, worn
weary: weariness, wearied, wearies
wedge: wedged
weep: weeping, wept
weigh: weighed
well: wells
west: westward
we: us, our, ours
what: whatever, whatsoever
wheel: wheels
where: whereby, wheresoever
where: wherever, wherein, whereof, wherefore
wherewith: wherewithal
while: whilst
whim: whims
whirlwind: whirlwinds
whisper: whispereth
white: whiteness
whither: whithersoever
whole: wholly
whore: whoredom, whoredoms
who: whosoever, whom, whomsoever, whomso, whoso, whose
wicked: wickedness, wickedly
widow: widows, widowhood
wield: wielded
wife: wives
wile: wiles
will: wilfully, willing, willingness, wills, wilfulness, wilt, would
wimple: wimples
window: windows
wind: winds
wing: wings
win: won
wise: wisdom
wish: wishes
witchcraft: witchcrafts
withdraw: withdrew, withdrewn
wither: withers, withered
withhold: withholding
withstand: withstood
with: within, without
witness: witnesseth, witnessing, witnessed, witnesses
wizard: wizards
woe: wo
wolf: wolves
woman: women
wonder: wondered, wondereth, wondering, wonderful, wonders, wonderfully
word: words
work: worked, workings, working, worketh, works, worker, workers, workest, workmen, workmanship
worm: worms
worry: worried
worship: worshiped, worshipers, worshiping
worthy: worthiness
would: wouldst
wound: wounds, wounded
wrath: wroth
wrest: wrested, wrestle, wrestled, wrestling
wretch: wretched
write: writeth, writings, writing, written, writ, wrote
wrong: wronged, wrongs, wrongful, wrongfully
year: years
yes: yea
yield: yields, yielding, yieldeth, yielded
yoke: yoketh
young: younger, youngest
you: yourself, yourselves, your, yours, thou, thee, thy, thine, thyself, ye
zeal: zealous, zealously
zoramite: zoramites
